1111111111111111111111111111111122222111111111111
1                                            !  1
1       ~                                       1
1 %                                    1111111111
1111111111111111111                             1
1            777771                             1
1            777771                             1
1            777771                             1
1                 1          1111331111         1
1                 1          1        1         1
1                 1          1      & 1         1
111111      1111111          1111111111         1
1                                               1
1                                               1
1                                               1
1           111111133311111111       11111111   1
1           1                1       1 !        1
1           1                1       1          1
1           1    $           1   o   177777     1
1           1                1       177777     1
1111111111111111111111111111111111111111111111111