1111111111111111111111111111111111111111111111111
1       1           1               7           1
1   $   3                           7        p  1
1       1           1               7         ! 1
1111111111111111111111111    11111111111111111111
1           7                1                  1
1    @      7                1    ~             1
1           7                1                  1
1111111111111111111111111    1111111111111111   1
1                                               1
1   1111111      1111    11111111111111111111   1
1   1  &  1      1               1        ! 1   1
1   1     1      1               3     %    1   1
1   3333333      1               3          1   1
1                1111111111111111111111111111   1
1   o       !                                   1
1111111111111111111111112221111111111111111111111