1111111111111111111111112221111111111111111111111
1                                             p 1
1   111     111     111     111     111         1
1   1 1     1 1     1 1     1 1     1 1    ~    1
1   111     111     1 1     111     111         1
1                   1 1                         1
1    11111111       1 4   p                     1
1    1 p  $ 1       1 4                         1
1    1      1       1 4       11111111          1
1    1      1       1 1       1      1      77771
1    13333111       1 1       111  111      7 ! 1
1                   1 1                     7   1
1                   1 1                     7   1
1    11111111       1 1       33331111      7   1
1    3    & 1       111       1      1      1 @ 1
1    3      1    o            1 !  % 1      1   1
1111111111111111111111111111111111111111111111111
