11111111111111111111111111111
1      !  8        1        1
1         8        1        1
1         8        1        1
1         1        1        5
1         1        1      o 5
1         1        1        5
1         1        1        1
1         1        1        1
1 !       1        8        1
1         1        8        1
11111111111111111111111111111